11111111
1C000001
10P00011
1C1000E1
11111111