11111111
1C000001
10P00001
1C00C0E1
11111111