1111111111
1000100001
100P1CE001
1111111111