1111111111111
10C1P000100C1
1001001E10111
10000010C0111
1111111111111