1111111111111111111111111111
1CCCCCCCCCCCCCCCCCCCCCCCCCC1
1C111000000000000000000000A1
1C100100000000000000000000A1
1C100101011010010111001011A1
1C11100110001001000P1011E1A1
1C100101000011110011101001A1
1C100101000000010100101001A1
1C100101000000010100101001A1
1C111101000011110111101001A1
1AAAAAAAAAAAAAAAAAAAAAAAAAA1
1111111111111111111111111111