1111111111111111111111111111
1A00000A1A000111000000000001
11111101111101C1011111111101
1A1A0100A000010101C000000001
1011010111000100010111111111
10A10101110111110101C0000001
10110100A0010001010101111101
1010010101010E01010100C00101
1010110101010P01010111110101
101011010101101101000000C101
10100001010A101C011111111101
10111111011110110000000000C1
1001100000000000011101111111
11000011111A1111111100000C11
1111111111111111111111111111