1111111111111111111
11100000000000001E1
11100000A00CCC00101
1110000AA0C000C0101
111000A0A00000C0101
11100A00A00000C0001
1000AAAAA0000C00111
10100000A000C000111
10100000A00C0000111
10100000A0CCCCC0111
1P10000000000000111
1111111111111111111