11111111111111111111
1C000001C01A0001A0A1
10111100100001010101
10000010100101A10101
1A1A1010001C0C110101
11C1C0A111C1C0C10101
10001010000A1CP10101
101000001110A1110101
1A1A1C11C000000001E1
11111111111111111111