1111111111111
1AC1P0001A0E1
1001001C10111
1A000010C0111
1111111111111