1111111111111111111111111
10000000010001000A1A1A0E1
1C1001C1000100010010001A1
11A1001A011A1A1A10A100101
100010011000A100001C1C0A1
1A100000101C1001A10001001
11001C1C10C1A01A1C0100101
1A1001A1001P1000010A10001
100000000000C1A10001C01C1
1111111111111111111111111