1111111111111111111111111111
10000000000000A0000000000001
101110111010011101C010111001
101E00101A100101011C101A0001
101110101010010101A110111001
100P10101010C101010A10101001
1011101110110111010010111C01
1000000C000000A0000000C00001
1111111111111111111111111111